@xwxyxxyxywxxyxwxyxx
y..................w
y..................w
y..................w
y..................w
y.....E............w
y.........M........w
y....wwwwwwwwwww...w
y..................w
y..................w
y..................w
y..................w
y..................w
xwyxwxxywwxyzxwxywxy
